#####################
#A     #       #    #
# ### ### ### ### # #
#   #     # #     # #
### ##### # ##### ###
#     C   #     C   #
# ### ##### ### ### #
# #         #     # #
# # ### ##### ### # #
#   #     C     # B #
#####################
