###################################################
#A      #   #     #                       #       #
# ##### # # # # ### # ### ##### ##### ### ##### ###
# #       #   #         #   # # #   #   # #   #   #
# # ## ## ############# ### # # # # ### # # # ### #
# # #   #   #   #     # #   # #   #     # # #     #
# # # # ### # ### ### ### ### ## ######## # ##### #
#   # #   # #   #   #   # # #   C   #   #   #   # #
# ##### ### ### ### ### # # # ### # # # ##### ### #
# #     #   C   #   # # # #     # #   #   #   #   #
# # # # # ####### # # # # # ### # ##### ### # # ###
# # # #     #   # #   # #   #     #   # #   #   # #
# # # #### ## # # #   #   # # ### ### # # ####### #
#   # #   C   #   # #   # # # #   #   # #   #     #
##### # ####### ###   ##  # # # # # ### ### # #####
#     # #     #     #     # # # # # #   #   #     #
# ##### # # # # ##### ##### # # # # # ### ####### #
# #   C   # # # #   #     # #   # #     #       # #
# #### ## # ### # # ## #### ###   ## ########## # #
#         #       #     C   #   #                B#
###################################################